アンパサンド	約物, ラテン語の語句, 論理記号
言語	言語, 言語学, 民族
日本語	日本語, 日本の言語, 日琉語族, 膠着語, SOV型言語
地理学	地理学, 社会科学, 人文科学, 自然科学, 地球科学の分野
国の一覧	国の一覧, 国名, 各国の地理
パリ	パリ, フランスの都市, ヨーロッパの首都, フランスの地域圏首府, 世界歴史都市連盟
ヨーロッパ	ヨーロッパ
生物	生物, 地球史
コケ植物	植物学, 陸上植物, コケ植物
社会学	社会学, オーギュスト・コント, 実証主義
古代エジプト	古代エジプト
エジプト	エジプト, 共和国, 軍事政権, フランコフォニー加盟国, 国際連合加盟国, アフリカ連合加盟国, イスラム協力機構加盟国
著作権の保護期間	著作権の保護期間, 著作権法, 独占
台東区	台東区, 東京都の特別区, 健康都市連合
地理	地理
生物学	生物学, 理学, 生命科学, 生物学の分野
社会	社会, 和製漢語, 哲学の和製漢語
こどもの文化	子供の遊び, 子供, 育児, テーマ別の文化
特撮	特撮, 映像作品, SFのジャンル, ホラーのジャンル, テレビドラマのジャンル, テレビ番組のジャンル
日常生活	生活, 文化用語, 人の一生
情報工学	情報工学, 情報学
形式言語	文法, 理論計算機科学, 形式言語, 構文解析 (プログラミング), 数学に関する記事, メタ論理学
文脈自由言語	形式言語, 構文解析 (プログラミング), 数学に関する記事
正規言語	有限オートマトン, 形式言語, 数学に関する記事
自然言語処理	言語学, 自然言語処理, 研究の計算分野
自然言語	諸言語, 言語学, 哲学的論理学, レトロニム
プログラミング言語	プログラミング言語, コンピュータ言語, プログラミング
人工知能	人工知能, 計算機科学, 情報工学, 工業, 工学, エンジニアリング, プログラミング, 情報通信業, 研究開発, 研究の計算分野, 計算論的神経科学, サイバネティックス, コンピュータのユーザインタフェース, 新技術, 形式科学, 計算機科学の未解決問題, 科学技術の倫理, 心の哲学
オーストリア	オーストリアの食文化, オーストリア, 内陸国, 欧州連合加盟国, 共和国, 連邦制国家, フランコフォニーのオブザーバー, 国際連合加盟国
GNU Free Documentation License	ライセンス, コピーレフト, 知的財産権, フリーソフトウェア財団, GNU Free Documentation License, 2008年設立
社会学者の一覧	社会学者, 学者の人名一覧
ゴーダチーズ	オランダのチーズ, 牛乳のチーズ
バールーフ・デ・スピノザ	バールーフ・デ・スピノザ, 17世紀のユダヤ神学者, 17世紀オランダの哲学者, オランダの神学者, ユダヤ人の哲学者, 啓蒙思想家, 政治哲学者, 形而上学者, 存在論の哲学者, 倫理学者, 心の哲学者, 決定論者, 汎神論者, ユダヤ人の懐疑論, ユダヤ人のヘブライ聖書学者, 科学革命, 破門, オランダ共和国の人物, オランダ・ギルダー紙幣の人物, セファルディ系ユダヤ人, ユダヤ系オランダ人, ポルトガル系オランダ人, アムステルダム出身の人物, 1632年生, 1677年没
文脈自由文法	形式言語, 数学に関する記事, プログラミング言語のトピック
フランス語	フランス語, フランスの言語, カナダの言語, ドイツの言語, スイスの言語, ベルギーの言語, ルクセンブルクの言語, ハイチの言語, レバノンの言語, モロッコの言語, コンゴ共和国の言語, コンゴ民主共和国の言語, チュニジアの言語, カメルーンの言語, マリ共和国の言語, セネガルの言語, トーゴの言語, ルワンダの言語, ブルンジの言語, ベナンの言語, マダガスカルの言語, コートジボワールの言語, インド・ヨーロッパ語族, ロマンス諸語
イタリア語	イタリア語, イタリアの言語, クロアチアの言語, スイスの言語, スロベニアの言語, マルタの言語, サンマリノの言語, アルバニアの言語, リビアの言語, エリトリアの言語, ソマリアの言語, インド・ヨーロッパ語族, ロマンス諸語
スペイン語	スペイン語, スペインの言語, アルゼンチンの言語, メキシコの言語, ボリビアの言語, チリの言語, コロンビアの言語, パラグアイの言語, ウルグアイの言語, インド・ヨーロッパ語族, ロマンス諸語
宗教学	宗教学
音楽	音楽, 聴覚, 芸術, 時間
インドネシア	インドネシア, 島国, 共和国, 国際連合加盟国, G20加盟国, イスラム協力機構加盟国
イラク	イラク, 西アジア, 中東, ペルシャ湾, 共和国, アラブ連盟, 連邦制国家, 国際連合加盟国
イラン	イラン, 共和国, イスラム教, イスラム国家, ファシズム, テロリズム, 国際連合加盟国, イスラム協力機構加盟国
タイ	英語の語句, 英語の姓, 英語の男性名, 同名の地名
チュニジア	チュニジア, 共和国, フランコフォニー加盟国, 国際連合加盟国, アフリカ連合加盟国, イスラム協力機構加盟国
トルコ	トルコ, 共和国, 国際連合加盟国, G20加盟国, イスラム協力機構加盟国
ロシア	ロシアの新聞, ロシア, G8加盟国, 独立国家共同体, 共和国, 連邦制国家, ロシア語圏, 国際連合加盟国, G20加盟国
哲学	哲学, 人文科学, 哲学の概念, 和製漢語, 哲学の和製漢語
ブラックミュージック	音楽のジャンル, 音楽のムーブメント, アフリカ系アメリカ人の音楽
物理学	物理学, 理学, 和製漢語
新聞学	メディア・スタディーズ, コミュニケーション学, 社会学の分野
ソクラテス	ソクラテス, 古代ギリシアの哲学者, 古代ギリシアの心の哲学者, 古代ギリシアの認識論の哲学者, 古代ギリシアの倫理学者, 古代ギリシアの政治哲学者, 古代アテナイの人物, 刑死した人物, 宗教懐疑論の人物, 紀元前5世紀の哲学者, 紀元前4世紀の哲学者, 紀元前460年代生, 紀元前399年没
スポーツ	スポーツ, ゲーム, 健康問題
両国国技館	関東地方の屋内競技施設, 東京都区部のスポーツ施設, 大相撲本場所の開催会場, 関東地方のバスケットボール競技施設, 関東地方のバレーボール競技施設, 日本のプロレス会場, 日本のボクシング会場, 卓球競技施設, 2020年東京オリンピックの会場, 東京都のコンサート会場, 第27回BCS賞, 墨田区のスポーツ, 墨田区の建築物, 1984年竣工の日本の建築物, 1985年開設のスポーツ施設, 日本のミニFM放送局, 本所, 占領軍に接収された日本の建築物, 1909年竣工の日本の建築物, 1909年開設のスポーツ施設, 1982年廃止のスポーツ施設, 1983年解体の建築物, 24時間テレビ, 関東大震災で被災した建築物
薬学	薬学
身体装飾	身体装飾, 身体論
宝石	Gemstones, 宝石, 石
液晶	液晶, 物質, 物質の相, ソフトマター
ネマティック液晶	液晶
文学	文学
音楽のジャンル一覧	音楽の一覧, 音楽のジャンル, メディア別のジャンル
音楽家	音楽家, 音楽関連の職業
アイシャ・ラドワーン	アラブの歌手, モロッコの歌手, 民俗音楽の音楽家, アラビア語の歌手, ベニ・メラル＝ヘニフラ地方出身の人物, 1962年生, 存命人物
言語学	言語学, 人文科学, 人類学
著作権	著作権法, 知的財産権, 情報社会, 独占, 日本の著作権法
映画	映画, フランスの発明
メーリングリスト	電子メール, インターネットの文化, フォーマット別の出版物
画像	映像
ピアノ	鍵盤楽器, ピアノ, イタリアの発明
医学	医学, 応用科学, 健康科学
FAQ	コンピュータの文化, テクニカル・コミュニケーション, 頭字語, アクロニム, 英語の成句
パブリックドメイン	知的財産法, パブリックドメイン, 日本の知的財産法
記録	記録
合理主義哲学	合理主義, 認識論的理論, 内在主義と外在主義
ミュージシャン一覧 (グループ)	音楽の人名一覧, 音楽グループ, 音楽家
曲名一覧	楽曲 (五十音別)
イエスタデイ (ビートルズの曲)	1965年の楽曲, 1965年のシングル, 1976年のシングル, ビートルズの楽曲, レノン＝マッカートニーが制作した楽曲, ジョージ・マーティンがプロデュースした楽曲, キャピトル・レコードのシングル, パーロフォンのシングル, 選抜高等学校野球大会入場行進曲, 第17回NHK紅白歌合戦歌唱楽曲, Billboard Hot 100 1位獲得作品, イギリスのギネス世界記録, ニュー・サウンズ・イン・ブラス, 失恋を題材とした楽曲, ポップ・バラード, 楽曲 い
Peer to Peer	P2P, コンピュータネットワーク
日本の漫画家	日本の漫画家
LimeWire	P2P, オープンソースソフトウェア, BitTorrent, Javaプラットフォームソフトウェア, ライム, トロイの木馬
日本の漫画作品一覧	漫画作品一覧, 日本の漫画
うる星やつら	うる星やつら, 漫画作品 う, 高橋留美子の漫画作品, 1978年の漫画, 週刊少年サンデーの漫画作品, SF漫画作品, ギャグ漫画, 恋愛漫画, ボーイ・ミーツ・ガール作品, 高等学校を舞台とした漫画作品, 小学館漫画賞少年少女部門, 日本で開発されたコンピュータゲーム
士郎正宗	士郎正宗, SF漫画家, 日本の漫画家, 尼崎市立尼崎高等学校出身の人物, 大阪芸術大学出身の人物, 神戸市出身の人物, 1961年生, 存命人物
アップルシード	漫画作品 あ, 士郎正宗, 漫画雑誌掲載漫画作品, 書き下ろし漫画作品, 月刊アフタヌーン, SF漫画作品, サイバーパンク映画, アニメ作品 あ, SFアニメ, 1988年のOVA, 日本のアニメ映画, コンピュータアニメーション映画, 3DCGアニメ, 東北新社のアニメ作品, NBCユニバーサル・ジャパンのアニメ映画, バンダイビジュアルのアニメ作品, 2004年のアニメ映画, TBS製作のアニメ映画, 東宝製作のアニメ映画, セガグループのアニメ作品, モーションキャプチャを使用した映画作品, 2007年のアニメ映画, 日本のSFアクション映画, 2011年のアニメ, スターチャイルドのアニメ作品, Production I.Gのアニメ作品, 漫画を原作とする映画作品, 警察官を主人公とした漫画, 警察官を主人公としたアニメ作品, サイボーグを題材とした漫画作品, サイボーグを題材としたアニメ映画
高橋留美子	高橋留美子, 日本の漫画家, 紫綬褒章受章者, 日本女子大学出身の人物, 新潟市出身の人物, アングレーム国際漫画祭グランプリ受賞者, アイズナー賞殿堂入りの人物, 1957年生, 存命人物
ゲーム	ゲーム, レジャー活動
コンピュータゲーム	コンピュータゲーム, 和製英語
ゲームのタイトル一覧	ゲーム関連の一覧, コンピュータゲーム関連一覧
ゲーム会社一覧	日本のコンピュータゲームメーカー・ブランド, 企業一覧, 日本の製造業者一覧, コンピュータゲーム関連一覧
民族音楽	民族音楽, 音楽のジャンル, 音楽理論, 伝統, 民族
村上もとか	村上もとか, 20世紀日本の教育者, 21世紀日本の教育者, 日本のマンガ・アニメ教育者, 日本の漫画家, 京都精華大学の教員, 東京都区部出身の人物, 1951年生, 存命人物
青木光恵	日本の漫画家, 兵庫県出身の人物, 夙川学院短期大学出身の人物, 1969年生, 存命人物
赤塚不二夫	赤塚不二夫, 日本の漫画家, 新聞連載の漫画家, 日本の司会者, 日本のタレント, 日本の男優, 落語立川流, 20世紀日本の俳優, 21世紀日本の俳優, トキワ荘, 紫綬褒章受章者, フジオ・プロダクションの人物, タモリ, 日本の引揚者, 承徳出身の人物, 1935年生, 2008年没
一条ゆかり	日本の漫画家, 岡山県出身の人物, 1949年生, 存命人物, 一条ゆかり
うすた京介	うすた京介, 日本の漫画家, 熊本県出身の人物, 愛知県出身の人物, 本名非公開の人物, 熊本県立大津高等学校出身の人物, 1974年生, 存命人物
浦沢直樹	日本の漫画家, 名古屋造形大学の教員, 経済学士取得者, 明星大学出身の人物, 東京都出身の人物, 1960年生, SF漫画家, 浦沢直樹, 存命人物, アイズナー賞の受賞対象
車田正美	日本の漫画家, 日本の作詞家, 東京都区部出身の人物, 東京都立日本橋高等学校出身の人物, 1953年生, 存命人物, 車田正美, 本宮ひろ志
高橋しん	日本の漫画家, 箱根駅伝の人物, 山梨学院大学出身の人物, 北海道出身の人物, 1967年生, 存命人物
高屋奈月	20世紀日本の女性著作家, 21世紀日本の女性著作家, 日本の漫画家, 東京都出身の人物, みんなのうたの映像制作者, 1973年生, 存命人物
竹本泉	日本の漫画家, SF漫画家, 日本大学出身の人物, 埼玉県出身の人物, 1959年生, 竹本泉, 存命人物
寺沢武一	日本の漫画家, SF漫画家, 北海道旭川東高等学校出身の人物, 北海道出身の人物, 1955年生, 存命人物, 手塚治虫
冨樫義博	日本の漫画家, 山形大学出身の人物, 山形県出身の人物, 武内直子, 1966年生, 存命人物
鳥山明	鳥山明, 日本の漫画家, 日本のデザイナー, 日本のキャラクターデザイナー, 芸術文化勲章受章者, 名古屋市出身の人物, 1955年生, 存命人物
永野のりこ	日本の漫画家, SF漫画家, 新聞連載の漫画家, 法政大学出身の人物, 東京都出身の人物, 生年非公表, 存命人物
聖悠紀	聖悠紀, 日本の漫画家, SF漫画家, 作画グループ, 愛知工業大学出身の人物, 新潟県出身の人物, 1949年生, 存命人物
日渡早紀	日本の漫画家, 川崎市立橘高等学校出身の人物, 神奈川県出身の人物, 1961年生, 存命人物
藤島康介	藤島康介, 日本の漫画家, 日本のイラストレーター, 千葉県立成東高等学校出身の人物, 千葉県出身の人物, 江川達也, 1964年生, 存命人物
山下和美	日本の漫画家, 新聞連載の漫画家, 北海道出身の人物, 1959年生, 存命人物
和田慎二	日本の漫画家, 日本の漫画原作者, 東海大学出身の人物, 広島県出身の人物, 1950年生, 2011年没, 和田慎二
タンゴ	音楽のジャンル, タンゴ, 中南米の音楽, アルゼンチンの音楽, ウルグアイの音楽, アルゼンチンのダンス, 中南米のダンス, 競技ダンス, 歌
スカ	スカ, 音楽のジャンル
六道神士	六道神士, 日本の漫画家, 同人作家, 九州産業大学出身の人物, 福岡県出身の人物, 1970年生, 存命人物
フォスター	英語の姓, ドイツ語の姓
エルヴィス・プレスリー	エルヴィス・プレスリー, アメリカ合衆国のロック歌手, アメリカ合衆国のポップ歌手, アメリカ合衆国の男優, ロックンロール・ミュージシャン, アメリカ先住民のミュージシャン, ロックの殿堂入りの人物, カントリー・ミュージックの殿堂入りの人物, ハリウッド・ウォーク・オブ・フェーム, オリコン年間アルバムチャート1位獲得アーティスト, RCAレコードのアーティスト, サン・レコードのアーティスト, グラミー賞受賞者, アメリカ合衆国のギネス世界記録保持者, アメリカ合衆国陸軍の軍人, 双子の芸能人, ドイツ系アメリカ人, フランス系アメリカ人, イングランド系アメリカ人, スコットランド系アメリカ人, アイルランド系アメリカ人, ミシシッピ州の人物, 1935年生, 1977年没
カーペンターズ	カーペンターズ, アメリカ合衆国の音楽グループ, ソフトロック・バンド, アダルト・コンテンポラリー, グラミー賞受賞者, A&Mレコードのアーティスト, 1969年に結成した音楽グループ, 1983年に解散した音楽グループ, 兄弟姉妹の音楽デュオ, 2人組の音楽グループ
スティーヴ・ライヒ	現代音楽の作曲家, ミニマリストの作曲家, アメリカ合衆国の作曲家, ユダヤ人の作曲家, ECMレコードのミュージシャン, ドイツユダヤ系アメリカ人, 東欧ユダヤ系アメリカ人, アメリカ芸術科学アカデミー会員, アメリカ芸術文学アカデミー会員, 高松宮殿下記念世界文化賞受賞者, ピューリッツァー賞受賞者, グラミー賞受賞者, 1936年生, 存命人物
ミニマル・ミュージック	ミニマリズム, 現代音楽, 音楽のジャンル, 音楽のムーブメント, ポストモダンアート
シカゴ	シカゴ, イリノイ州の都市, クック郡 (イリノイ州), デュページ郡 (イリノイ州), アメリカ合衆国の計画都市, アメリカ合衆国の観光地
岩手県	岩手県の医療機関, 日本の都道府県, 岩手県
個人	哲学の概念, 人間, 人権, 徳
赤石路代	赤石路代, 日本の漫画家, さいたま市出身の人物, 芸術学士取得者, 武蔵野美術大学出身の人物, 埼玉県立浦和第一女子高等学校出身の人物, 存命人物, 1959年生
ゴスペル	英語の語句
Cascading Style Sheets	W3C勧告, World Wide Web, スタイルシート言語, HTML
吉田秋生	日本の漫画家, SF漫画家, 東京都区部出身の人物, 芸術学士取得者, 武蔵野美術大学出身の人物, 1956年生, 存命人物, 吉田秋生
津田雅美	日本の漫画家, 神奈川県出身の人物, 1970年生, 存命人物
藤崎竜	日本の漫画家, 日本のイラストレーター, SF漫画家, 青森県出身の人物, 1971年生, 存命人物
検索エンジン	検索エンジン, 情報検索システム, World Wide Web
テレビ	テレビ
テレビ番組	テレビ番組
ナイトライダー	SFテレビドラマ, アクションドラマ, 特撮テレビ番組, アメリカ合衆国のテレビドラマ, カリフォルニア州を舞台としたテレビ番組, NBC, ユニバーサル・ピクチャーズの作品, 1982年のテレビドラマ, 1980年代の特撮作品, テレビ朝日のテレビドラマ, テレビ朝日月曜8時枠の連続ドラマ, テレビ朝日水曜8時枠の連続ドラマ, テレビ朝日の特撮番組, 自動車を題材としたテレビドラマ, 人工知能を題材としたフィクション作品, 自律ロボットを題材としたテレビドラマ, 探偵を主人公としたテレビドラマ, 1988年のコンピュータゲーム, ファミリーコンピュータ用ソフト
将軍	軍人, 軍事史, 将軍, 政治史, 爵位, 領主・貴族の称号, 政治家・官僚の称号, 軍人・戦士の称号
蝦夷	飛鳥時代, 奈良時代, 平安時代, 蝦夷, 古代日本の部族, 鬼
高橋葉介	駒澤大学出身の人物, 東京都出身の人物, 日本の漫画家, 日本の漫画原作者, ホラーに関連する人物, 1956年生, 存命人物
数学	数学, 形式科学, 理学, 数学に関する記事, 数学史
食文化	食文化
飲む	水, 飲食, 動詞, 飲酒文化, 動物行動学, 生理学
ペンシルベニアドイツ語	ドイツ語の方言, ドイツ語, アレマン語, アメリカ合衆国の言語, カナダの言語, ペンシルベニア・ドイツ文化, アーミッシュ, ペンシルベニア州の文化, ペンシルベニア州の歴史
地学	教科
アーミッシュ	アーミッシュ, プロテスタントの教派, アメリカ合衆国のプロテスタント, アメリカ合衆国の民族, ドイツ系アメリカ人, ドイツ系人, 民族集団, 平和教会, 少数民族, シンプルライフ
イラストレーター	イラストレーター, 美術関連の職業
風邪	風邪, 症候, 冬の季語, 熟字訓, 呼吸器疾患, ウイルス感染症, 小児科学, 耳鼻咽喉科学
政治学	社会科学, 政治学, 政治
内閣総理大臣の一覧	日本の内閣総理大臣, 日本の国務大臣, 日本の政治家一覧, 首相の一覧
赤松健	赤松健, 日本の漫画家, 表現の自由を求める活動家, 自由民主党の参議院議員, 比例区選出の参議院議員, 令和時代の参議院議員, 中央大学出身の人物, 海城高等学校出身の人物, 名古屋市出身の人物, 神奈川県出身の人物, 東京都出身の人物, 1968年生, 存命人物
麻宮騎亜	麻宮騎亜, 日本の漫画家, SF漫画家, 岩手県出身の人物, 1963年生, 存命人物
あずまきよひこ	日本の漫画家, 学士（芸術工学）取得者, 神戸芸術工科大学出身の人物, 兵庫県出身の人物, 1968年生, 存命人物
岡田芽武	日本の漫画家, 日本の漫画原作者, 東京都出身の人物, 1971年生, 存命人物
桂正和	桂正和, 木更津総合高等学校出身の人物, 日本の漫画家, SF漫画家, 嵯峨美術大学の教員, 福井県出身の人物, 千葉県出身の人物, 1962年生, 存命人物
こいおみなと	日本の漫画家, 同人作家, 岐阜県出身の人物, 1968年生, 存命人物
ここまひ	日本の漫画家, 日本のイラストレーター, 東京都区部出身の人物, 存命人物
桜野みねね	日本の漫画家, 仙台市出身の人物, 東京都出身の人物, 1973年生, 存命人物
高屋良樹	日本の漫画家, 秋田県出身の人物, 1960年生, 存命人物
田中久仁彦	日本の漫画家, 日本のイラストレーター, ゲームのグラフィッカー・原画家, 川崎市出身の人物, 日本ファルコムの人物, 1970年生, 存命人物
鶴田洋久	日本の漫画家, 埼玉県出身の人物, 1964年生, 存命人物
内藤泰弘	日本の漫画家, 法政大学出身の人物, 横浜市出身の人物, 1967年生, 存命人物
萩原一至	日本の漫画家, 同人作家, 東京都区部出身の人物, 1963年生, 存命人物
舞井武依	日本の漫画家, 存命人物
幻超二	日本の漫画家, 岡山県出身の人物, 1969年生, 存命人物
美衣暁	日本の漫画家, 三重県出身の人物, 1963年生, 存命人物
三浦建太郎	日本の漫画家, 日本大学出身の人物, 千葉県出身の人物, 本名非公開の人物, 1966年生, 2021年没
皆川亮二	皆川亮二, 日本の漫画家, SF漫画家, 東京都区部出身の人物, 1964年生, 存命人物
秋田県	秋田県の企業, 秋田県の医療機関, 日本の都道府県, 秋田県
石川県	石川県の道路, 日本の都道府県, 石川県
愛媛県	愛媛県の医療機関, 日本の都道府県, 愛媛県
大分県	大分県の医療機関, 大分県の神社, 大分県の温泉, 大分県の祭り, 日本の都道府県, 大分県
岡山県	岡山県の医療機関, 岡山県のケーブルテレビ局, 岡山県の大学, 日本の都道府県, 岡山県
沖縄県	沖縄県の医療機関, 沖縄県の大学, 日本の都道府県, 沖縄県
香川県	香川県の医療機関, 日本の都道府県, 香川県
岐阜県	岐阜県の医療機関, 岐阜県のケーブルテレビ局, 日本の都道府県, 岐阜県
熊本県	熊本県の医療機関, 熊本県の食文化, 日本の都道府県, 熊本県
高知県	高知県の医療機関, 高知県の公園, 高知県の寺, 高知県の博物館, 高知県のスポーツ施設, 高知県の祭り, 日本の都道府県, 高知県
佐賀県	佐賀県の食文化, 日本の都道府県, 佐賀県
滋賀県	滋賀県の医療機関, 近江米, 日本の都道府県, 滋賀県, 高松宮記念杯競輪
静岡県	静岡県の医療機関, 静岡県の大学, 日本の都道府県, 静岡県
島根県	島根県の医療機関, 島根県のケーブルテレビ局, 島根県の重要文化財, 島根県の祭り, 島根県の音楽, 島根県, 日本の都道府県
徳島県	徳島県の医療機関, 日本の都道府県, 徳島県
栃木県	栃木県の医療機関, 日本の都道府県, 栃木県
鳥取県	鳥取県の医療機関, 鳥取県のケーブルテレビ局, 日本の都道府県, 鳥取県
長崎県	長崎県の医療機関, 日本の都道府県, 長崎県
長野県	長野県の医療機関, 日本の都道府県, 長野県
新潟県	新潟県の医療機関, 新潟県の大学, 新潟県のケーブルテレビ局, 日本の都道府県, 新潟県
兵庫県	兵庫県の医療機関, 兵庫県の大学, 兵庫県の食文化, 日本の都道府県, 兵庫県
広島県	広島県の医療機関, 広島県のケーブルテレビ局, 日本の都道府県, 広島県
福井県	福井県の医療機関, 福井県の自然景勝地, 福井県の温泉, 福井県のスキー場, 福井県の公園, 日本の都道府県, 福井県
福島県	福島県の企業, 福島県の医療機関, 日本の都道府県, 福島県
北海道	北海道の医療機関, 北海道地方の空港, 北海道, 日本の都道府県, 日本の地域ブロック, 日本の島, 北海道の島
宮崎県	宮崎県の医療機関, 宮崎県の自然景勝地, 宮崎県の企業, 日本の都道府県, 宮崎県
山口県	山口県の医療機関, 山口県の食文化, 山口県の自然景勝地, 日本の都道府県, 山口県
山梨県	山梨県の医療機関, 山梨県の自然景勝地, 山梨県の寺, 山梨県の祭り, 日本の都道府県, 山梨県
和歌山県	和歌山県の医療機関, 和歌山県のケーブルテレビ局, 和歌山県のスポーツ施設, 日本の第三種鉄道事業者, 日本の都道府県, 和歌山県
諸星大二郎	SF漫画家, 地方公務員出身の人物, 東京都区部出身の人物, 長野県出身の人物, 日本の漫画家, ホラーに関連する人物, 諸星大二郎, 1949年生, 存命人物
首都	都市, 行政, 首都
国の一覧 (大陸別)	国の一覧, 大陸別の国, 国名
東京を舞台とした映画作品一覧	東京都を舞台とした映画作品, 映画作品の一覧, 各都道府県を舞台とした作品一覧
水縞とおる	日本の漫画家, 大阪府出身の人物, 1964年生, 存命人物
恋人は守護霊!?	漫画作品 こ, 月刊コミックNORA
封神演義	封神演義, 中国の小説, 16世紀の小説, 明代の書籍, 歴史小説, ファンタジー小説, 道教, 夏殷周, 中国神話を題材にした作品, 神話を題材とした小説, 中国の歴史を題材とした小説
ああっ女神さまっ	ああっ女神さまっ, 藤島康介, 漫画作品 あ, 1988年の漫画, 月刊アフタヌーン, ファンタジー漫画, 神話を題材とした漫画作品, 北欧神話を題材とした作品, 大学を舞台とした漫画作品, 千葉県を舞台とした漫画作品, 兄弟姉妹を題材とした作品, ボーイ・ミーツ・ガール作品, アニメ作品 あ, 1993年のOVA, 2011年のOVA, 2005年のテレビアニメ, TBSの深夜アニメ, 2000年のアニメ映画, 日本のテレビアニメの劇場版, 松竹のアニメ映画, 浜口史郎の作曲映画, AIC, ポニーキャニオンのアニメ作品, バンダイビジュアルのアニメ作品, メモリーテックのアニメ作品, ムービックのアニメ作品, 電通のアニメ作品, モーニングKCのアニメ作品, ファンタジーアニメ, 大学を舞台としたアニメ作品, 2006年の小説, 1993年のコンピュータゲーム, 2000年のコンピュータゲーム, 2007年のコンピュータゲーム, PC-9800シリーズ用ゲームソフト, PC-FX用ソフト, アーケードゲーム作品, ドリームキャスト用ソフト, PlayStation 2用ソフト, マーベラスのゲームソフト, ファンタジーコンピュータゲーム, ドラマCD
西原理恵子	西原理恵子, 日本の漫画家, 新聞連載の漫画家, 武蔵野美術大学出身の人物, 高知県出身の人物, 1964年生, 存命人物, キノベス!
里中満智子	里中満智子, 日本の漫画家, 20世紀日本の女性著作家, 21世紀日本の女性著作家, 20世紀日本の女性教育者, 21世紀日本の女性教育者, 日本のマンガ・アニメ教育者, 日本ペンクラブ会員, 大阪市出身の人物, 大阪市立桜宮高等学校出身の人物, 1948年生, 存命人物
椎名高志	日本の漫画家, 京都市立芸術大学出身の人物, 大阪府出身の人物, 1965年生, 存命人物, 椎名高志
篠原千絵	篠原千絵, 20世紀日本の女性著作家, 21世紀日本の女性著作家, 20世紀日本の女性教育者, 21世紀日本の女性教育者, 日本の漫画家, 日本の女性小説家, 日本のマンガ・アニメ教育者, 神奈川県出身の人物, 存命人物, 生年未記載
介錯	武士, 死の幇助, 日本の文化, 演劇, 和製漢語, 切腹
川原泉	川原泉, 日本の漫画家, SF漫画家, 鹿児島大学出身の人物, 鹿児島県出身の人物, 1960年生, 存命人物
尾田栄一郎	日本の漫画家, 熊本市出身の人物, 日本のギネス世界記録保持者, 和月伸宏, 1975年生, 存命人物
唐沢なをき	唐沢なをき, 日本の漫画家, SF漫画家, 新聞連載の漫画家, 同人作家, 札幌市出身の人物, 1961年生, 存命人物

